abbot	COMMON_MALE	SINGULAR	1.0
actor	COMMON_MALE	SINGULAR	1.0
bachelor	COMMON_MALE	SINGULAR	1.0
baron	COMMON_MALE	SINGULAR	1.0
beau	COMMON_MALE	SINGULAR	1.0
billy-goat	COMMON_MALE	SINGULAR	1.0
boar	COMMON_MALE	SINGULAR	1.0
boy	COMMON_MALE	SINGULAR	1.0
bridegroom	COMMON_MALE	SINGULAR	1.0
brother	COMMON_MALE	SINGULAR	1.0
buck	COMMON_MALE	SINGULAR	1.0
buck-rabbit	COMMON_MALE	SINGULAR	1.0
bull	COMMON_MALE	SINGULAR	1.0
bull-calf	COMMON_MALE	SINGULAR	1.0
bullock	COMMON_MALE	SINGULAR	1.0
cock	COMMON_MALE	SINGULAR	1.0
cock-sparrow	COMMON_MALE	SINGULAR		1.0
colt	COMMON_MALE	SINGULAR	1.0
count	COMMON_MALE	SINGULAR	1.0
dog	COMMON_MALE	SINGULAR	1.0
drake	COMMON_MALE	SINGULAR	1.0
duke	COMMON_MALE	SINGULAR	1.0
earl	COMMON_MALE	SINGULAR	1.0
emperor	COMMON_MALE	SINGULAR	1.0
enchanter	COMMON_MALE	SINGULAR	1.0
father	COMMON_MALE	SINGULAR	1.0
father-in-law	COMMON_MALE	SINGULAR	1.0
fiance	COMMON_MALE	SINGULAR	1.0
friar	COMMON_MALE	SINGULAR	1.0
gander	COMMON_MALE	SINGULAR	1.0
gentleman	COMMON_MALE	SINGULAR	1.0
god	COMMON_MALE	SINGULAR	1.0
grandfather	COMMON_MALE	SINGULAR	1.0
hart	COMMON_MALE	SINGULAR	1.0
he	COMMON_MALE	SINGULAR	1.0
he-goat	COMMON_MALE	SINGULAR	1.0
headmaster	COMMON_MALE	SINGULAR	1.0
heir	COMMON_MALE	SINGULAR	1.0
hero	COMMON_MALE	SINGULAR	1.0
him	COMMON_MALE	SINGULAR	1.0
host	COMMON_MALE	SINGULAR	1.0
hound	COMMON_MALE	SINGULAR	1.0
husband	COMMON_MALE	SINGULAR	1.0
king	COMMON_MALE	SINGULAR	1.0
lad	COMMON_MALE	SINGULAR	1.0
lion	COMMON_MALE	SINGULAR	1.0
lord	COMMON_MALE	SINGULAR	1.0
male	COMMON_MALE	SINGULAR	1.0
male-child	COMMON_MALE	SINGULAR	1.0
man	COMMON_MALE	SINGULAR	1.0
manservant	COMMON_MALE	SINGULAR	1.0
marquis	COMMON_MALE	SINGULAR	1.0
masseur	COMMON_MALE	SINGULAR	1.0
master	COMMON_MALE	SINGULAR	1.0
mayor	COMMON_MALE	SINGULAR	1.0
monk	COMMON_MALE	SINGULAR	1.0
Mr	COMMON_MALE	SINGULAR	1.0
nephew	COMMON_MALE	SINGULAR	1.0
postman	COMMON_MALE	SINGULAR	1.0
postmaster	COMMON_MALE	SINGULAR	1.0
priest	COMMON_MALE	SINGULAR	1.0
prince	COMMON_MALE	SINGULAR	1.0
ram	COMMON_MALE	SINGULAR	1.0
shepherd	COMMON_MALE	SINGULAR	1.0
sir	COMMON_MALE	SINGULAR	1.0
sire	COMMON_MALE	SINGULAR	1.0
son	COMMON_MALE	SINGULAR	1.0
son-in-law	COMMON_MALE	SINGULAR	1.0
sorcerer	COMMON_MALE	SINGULAR	1.0
stag	COMMON_MALE	SINGULAR	1.0
stallion	COMMON_MALE	SINGULAR	1.0
steer	COMMON_MALE	SINGULAR	1.0
stepfather	COMMON_MALE	SINGULAR	1.0
stepson	COMMON_MALE	SINGULAR	1.0
steward	COMMON_MALE	SINGULAR	1.0
Sultan	COMMON_MALE	SINGULAR	1.0
tiger	COMMON_MALE	SINGULAR	1.0
tutor	COMMON_MALE	SINGULAR	1.0
uncle	COMMON_MALE	SINGULAR	1.0
waiter	COMMON_MALE	SINGULAR	1.0
widower	COMMON_MALE	SINGULAR	1.0
wizard	COMMON_MALE	SINGULAR	1.0
rooster	COMMON_MALE	SINGULAR	1.0
fox	COMMON_MALE	SINGULAR	1.0
jack	COMMON_MALE	SINGULAR	1.0
abbess	COMMON_FEMALE	SINGULAR	1.0
actress	COMMON_FEMALE	SINGULAR	1.0
spinster	COMMON_FEMALE	SINGULAR	1.0
baroness	COMMON_FEMALE	SINGULAR	1.0
belle	COMMON_FEMALE	SINGULAR	1.0
nanny-goat	COMMON_FEMALE	SINGULAR	1.0
sow	COMMON_FEMALE	SINGULAR	1.0
girl	COMMON_FEMALE	SINGULAR	1.0
bride	COMMON_FEMALE	SINGULAR	1.0
sister	COMMON_FEMALE	SINGULAR	1.0
doe	COMMON_FEMALE	SINGULAR	1.0
doe-rabbit	COMMON_FEMALE	SINGULAR	1.0
cow	COMMON_FEMALE	SINGULAR	1.0
cow-calf	COMMON_FEMALE	SINGULAR	1.0
heifer	COMMON_FEMALE	SINGULAR	1.0
hen	COMMON_FEMALE	SINGULAR	1.0
hen-sparrow	COMMON_FEMALE	SINGULAR	1.0
filly	COMMON_FEMALE	SINGULAR	1.0
countess	COMMON_FEMALE	SINGULAR	1.0
bitch	COMMON_FEMALE	SINGULAR	1.0
duck	COMMON_FEMALE	SINGULAR	1.0
duchess	COMMON_FEMALE	SINGULAR	1.0
countess	COMMON_FEMALE	SINGULAR	1.0
empress	COMMON_FEMALE	SINGULAR	1.0
enchantress	COMMON_FEMALE	SINGULAR	1.0
mother	COMMON_FEMALE	SINGULAR	1.0
mother-in-law	COMMON_FEMALE	SINGULAR	1.0
fiancee	COMMON_FEMALE	SINGULAR	1.0
Frances	COMMON_FEMALE	SINGULAR	1.0
nun	COMMON_FEMALE	SINGULAR	1.0
goose	COMMON_FEMALE	SINGULAR	1.0
lady	COMMON_FEMALE	SINGULAR	1.0
goddess	COMMON_FEMALE	SINGULAR	1.0
grandmother	COMMON_FEMALE	SINGULAR	1.0
hind	COMMON_FEMALE	SINGULAR	1.0
she	COMMON_FEMALE	SINGULAR	1.0
she-goat	COMMON_FEMALE	SINGULAR	1.0
headmistress	COMMON_FEMALE	SINGULAR	1.0
heiress	COMMON_FEMALE	SINGULAR	1.0
heroine	COMMON_FEMALE	SINGULAR	1.0
her	COMMON_FEMALE	SINGULAR	1.0
hostess	COMMON_FEMALE	SINGULAR	1.0
brach	COMMON_FEMALE	SINGULAR	1.0
wife	COMMON_FEMALE	SINGULAR	1.0
queen	COMMON_FEMALE	SINGULAR	1.0
lass	COMMON_FEMALE	SINGULAR	1.0
landlady	COMMON_FEMALE	SINGULAR	1.0
lioness	COMMON_FEMALE	SINGULAR	1.0
lady	COMMON_FEMALE	SINGULAR	1.0
female	COMMON_FEMALE	SINGULAR	1.0
female-child	COMMON_FEMALE	SINGULAR	1.0
woman	COMMON_FEMALE	SINGULAR	1.0
maidservant	COMMON_FEMALE	SINGULAR	1.0
marchioness	COMMON_FEMALE	SINGULAR	1.0
masseuse	COMMON_FEMALE	SINGULAR	1.0
mistress	COMMON_FEMALE	SINGULAR	1.0
mayoress	COMMON_FEMALE	SINGULAR	1.0
nun	COMMON_FEMALE	SINGULAR	1.0
Mrs	COMMON_FEMALE	SINGULAR	1.0
niece	COMMON_FEMALE	SINGULAR	1.0
postwoman	COMMON_FEMALE	SINGULAR	1.0
postmistress	COMMON_FEMALE	SINGULAR	1.0
priestess	COMMON_FEMALE	SINGULAR	1.0
princess	COMMON_FEMALE	SINGULAR	1.0
ewe	COMMON_FEMALE	SINGULAR	1.0
shepherdess	COMMON_FEMALE	SINGULAR	1.0
madam	COMMON_FEMALE	SINGULAR	1.0
dam	COMMON_FEMALE	SINGULAR	1.0
daughter	COMMON_FEMALE	SINGULAR	1.0
daughter-in-law	COMMON_FEMALE	SINGULAR	1.0
sorceress	COMMON_FEMALE	SINGULAR	1.0
hind	COMMON_FEMALE	SINGULAR	1.0
mare	COMMON_FEMALE	SINGULAR	1.0
heifer	COMMON_FEMALE	SINGULAR	1.0
stepmother	COMMON_FEMALE	SINGULAR	1.0
stepdaughter	COMMON_FEMALE	SINGULAR	1.0
stewardess	COMMON_FEMALE	SINGULAR	1.0
Sultana	COMMON_FEMALE	SINGULAR	1.0
tigress	COMMON_FEMALE	SINGULAR	1.0
governess	COMMON_FEMALE	SINGULAR	1.0
aunt	COMMON_FEMALE	SINGULAR	1.0
waitress	COMMON_FEMALE	SINGULAR	1.0
widow	COMMON_FEMALE	SINGULAR	1.0
witch	COMMON_FEMALE	SINGULAR	1.0
roe	COMMON_FEMALE	SINGULAR	1.0
hen	COMMON_FEMALE	SINGULAR	1.0
vixen	COMMON_FEMALE	SINGULAR	1.0
sow	COMMON_FEMALE	SINGULAR	1.0
jenny	COMMON_FEMALE	SINGULAR	1.0