she	PRONOUN_FEMALE	SINGULAR
her PRONOUN_FEMALE	SINGULAR
hers	PRONOUN_FEMALE	SINGULAR
herself	PRONOUN_FEMALE	SINGULAR
he	PRONOUN_MALE	SINGULAR
him	PRONOUN_MALE	SINGULAR
his	PRONOUN_MALE	SINGULAR
himself	PRONOUN_MALE	SINGULAR
it	PRONOUN_NEUTRAL	SINGULAR
its	PRONOUN_NEUTRAL	SINGULAR
itself	PRONOUN_NEUTRAL	SINGULAR
they PRONOUN_NEUTRAL	PLURAL
them PRONOUN_NEUTRAL	PLURAL
their PRONOUN_NEUTRAL	PLURAL
theirs PRONOUN_NEUTRAL	PLURAL
themselves PRONOUN_NEUTRAL	PLURAL
we PRONOUN_NEUTRAL	PLURAL
us PRONOUN_NEUTRAL	PLURAL
our PRONOUN_NEUTRAL	PLURAL
ours PRONOUN_NEUTRAL	PLURAL